characters,search_terms,search_space_size,names_by_length,unresolved_items,disambiguated_names,possible_misses,KPraw,%KP
1,24,224,0,219,5,200,0,0.0
2,93,219,0,178,46,126,74,0.3304
3,127,178,0,80,144,51,75,0.3348
4,60,80,0,31,193,20,31,0.1384
5,18,31,0,21,203,13,7,0.0312
6,13,21,0,12,212,8,5,0.0223
7,5,12,0,11,213,7,1,0.0045
8,5,11,0,9,215,6,1,0.0045
9,8,9,0,2,222,1,5,0.0223
10,1,2,0,2,222,1,0,0.0
11,1,2,1,2,222,1,0,0.0
12,1,1,0,0,223,0,1,0.0045
