characters,search_terms,search_space_size,names_by_length,unresolved_items,disambiguated_names,possible_misses,KPraw,%KP
1,16,43,0,31,12,27,0,0.0
2,10,31,0,26,17,21,6,0.1395
3,6,26,0,26,17,20,1,0.0233
4,7,26,0,24,19,19,1,0.0233
5,5,24,0,24,19,19,0,0.0
6,5,24,0,24,19,19,0,0.0
7,5,24,0,24,19,19,0,0.0
8,20,24,1,7,36,4,15,0.3488
9,3,6,1,5,37,3,1,0.0233
10,3,4,0,2,39,1,2,0.0465
11,1,2,0,2,39,1,0,0.0
12,2,2,0,0,41,0,1,0.0233
